Abadon	muž
Abraham	muž
Adam	muž
Adolf	muž
Alan	muž
Albert	muž
Albrecht	muž
Aleš	muž
Alexej	muž
Alfréd	muž
Alva	muž
Alvin	muž
Amand	muž
Ambrož	muž
Anastáz	muž
Anděl	muž
Anselm	muž
Antonín	muž
Ariel	muž
Arkád	muž
Armin	muž
Arnold	muž
Artur	muž
Arzen	muž
Atila	muž
Aurel	muž
Baltazar	muž
Bartoloměj	muž
Beatus	muž
Benedikt	muž
Bernard	muž
Bertram	muž
Blahomil	muž
Blahoslav	muž
Bohdan	muž
Bohumil	muž
Bohuslav	muž
Bojan	muž
Boleslav	muž
Boris	muž
Bořislav	muž
Božetěch	muž
Božislav	muž
Branislav	muž
Brian	muž
Bruno	muž
Budimír	muž
Budivoj	muž
Celestýn	muž
Ctibor	muž
Ctislav	muž
Cyril	muž
Čestmír	muž
Dalimil	muž
Damián	muž
Daniel	muž
Darius	muž
Denis	muž
Dětmar	muž
Dezider	muž
Dluhoš	muž
Dobromír	muž
Dominik	muž
Donát	muž
Drahomil	muž
Drahoslav	muž
Drahotín	muž
Edgar	muž
Edvard	muž
Egmont	muž
Eliáš	muž
Elmar	muž
Emanuel	muž
Emil	muž
Erazim	muž
Erik	muž
Ervín	muž
Evald	muž
Evarist	muž
Ezechiel	muž
Fabián	muž
Fedor	muž
Ferdinand	muž
Filemon	muž
Filip	muž
Flavián	muž
Florián	muž
František	muž
Gabin	muž
Gál	muž
Gaston	muž
Genadij	muž
Gerard	muž
Géza	muž
Gleb	muž
Gorazd	muž
Gothard	muž
Grant	muž
Gustav	muž
Harald	muž
Havel	muž
Herbert	muž
Hilar	muž
Homér	muž
Horác	muž
Horymír	muž
Hostislav	muž
Hugo	muž
Hyacint	muž
Hypolit	muž
Chranibor	muž
Chrudoš	muž
Ignác	muž
Ilja	muž
Irenej	muž
Ivan	muž
Ivo	muž
Izák	muž
Izmael	muž
Jáchym	muž
Jan	muž
Jarolím	muž
Jaroslav	muž
Jeremiáš	muž
Jiljí	muž
Jindřich	muž
Jonáš	muž
Jordan	muž
Jošt	muž
Julius	muž
Kajetán	muž
Karel	muž
Kastor	muž
Kazimír	muž
Kim	muž
Knut	muž
Kolombín	muž
Konstantýn	muž
Kosma	muž
Krasoslav	muž
Kryšpín	muž
Křesomysl	muž
Květoslav	muž
Kvido	muž
Lambert	muž
Laurenc	muž
Leandr	muž
Leodegar	muž
Leonid	muž
Leopold	muž
Lešek	muž
Libor	muž
Lionel	muž
Lotar	muž
Lubor	muž
Lucián	muž
Ludivoj	muž
Ludoslav	muž
Lukáš	muž
Lumír	muž
Magnus	muž
Manfréd	muž
Manuel	muž
Marek	muž
Marin	muž
Martin	muž
Matouš	muž
Maxmilián	muž
Medard	muž
Merlin	muž
Metod	muž
Mikoláš	muž
Milíč	muž
Miloň	muž
Miloslav	muž
Milota	muž
Milovan	muž
Miromil	muž
Miroslav	muž
Mnata	muž
Modest	muž
Mojžíš	muž
Moric	muž
Myrtil	muž
Narcis	muž
Natanael	muž
Neklan	muž
Nezamysl	muž
Nikodém	muž
Norbert	muž
Odolen	muž
Oktavián	muž
Olbram	muž
Oleg	muž
Omar	muž
Orest	muž
Osvald	muž
Otakar	muž
Ovidius	muž
Pankrác	muž
Paris	muž
Pavel	muž
Perikles	muž
Petronius	muž
Platón	muž
Pravdomil	muž
Prosper	muž
Přibyslav	muž
Radhost	muž
Radivoj	muž
Radomír	muž
Radovan	muž
Rafael	muž
Rainald	muž
Rainhard	muž
Ralf	muž
Randolf	muž
Ratibor	muž
Redmond	muž
Remus	muž
René	muž
Robert	muž
Robinson	muž
Roderik	muž
Roch	muž
Rolf	muž
Romeo	muž
Romul	muž
Rostislav	muž
Rudolf	muž
Rupert	muž
Řehoř	muž
Samson	muž
Saturnin	muž
Sáva	muž
Sedrik	muž
Serenus	muž
Servác	muž
Sidon	muž
Silván	muž
Simeon	muž
Sixt	muž
Slaviboj	muž
Slavomil	muž
Smil	muž
Sokrat	muž
Spytihněv	muž
Stanislav	muž
Stojmír	muž
Svatomír	muž
Svatoslav	muž
Svetozar	muž
Šavel	muž
Šťasta	muž
Tadeáš	muž
Taras	muž
Teodor	muž
Teodoz	muž
Teofil	muž
Tiber	muž
Tichomil	muž
Tichon	muž
Timotej	muž
Titus	muž
Tomáš	muž
Torkvát	muž
Tristan	muž
Ulrich	muž
Urban	muž
Václav	muž
Valdemar	muž
Valerián	muž
Vasil	muž
Veleslav	muž
Věnceslav	muž
Verner	muž
Vidor	muž
Vilém	muž
Vilmar	muž
Virgil	muž
Vít	muž
Vitold	muž
Vladan	muž
Vladislav	muž
Vlastimil	muž
Vlastislav	muž
Vojen	muž
Vojmír	muž
Vojtěch	muž
Vratislav	muž
Všebor	muž
Všeslav	muž
Zachar	muž
Zbyhněv	muž
Zbyslav	muž
Zderad	muž
Zeno	muž
Zlatan	muž
Zoltán	muž
Zoroslav	muž
Zvonimír	muž
Ždan	muž
Želimír	muž
Žitomír	muž
Živan	muž
Abdon	muž
Abelard	muž
Abrahám	muž
Adalbert	muž
Adin	muž
Adrián	muž
Achil	muž
Alban	muž
Albín	muž
Aldo	muž
Alexandr	muž
Alfons	muž
Alois	muž
Alvar	muž
Amadeus	muž
Amát	muž
Anatol	muž
Andrej	muž
Antal	muž
Aram	muž
Aristid	muž
Armand	muž
Arne	muž
Arnošt	muž
Artuš	muž
Atanas	muž
August	muž
Axel	muž
Barnabáš	muž
Bazil	muž
Bedřich	muž
Benjamín	muž
Bertold	muž
Bivoj	muž
Blahomír	muž
Blažej	muž
Bohuchval	muž
Bohumír	muž
Bohuš	muž
Bolemír	muž
Bonifác	muž
Bořek	muž
Bořivoj	muž
Božidar	muž
Branimír	muž
Bratislav	muž
Brit	muž
Břetislav	muž
Budislav	muž
Cecil	muž
Cézar	muž
Ctirad	muž
Cyprián	muž
Čeněk	muž
Čistoslav	muž
Dalibor	muž
Dalimír	muž
Dan	muž
Darek	muž
David	muž
Děpold	muž
Dětřich	muž
Dimitrij	muž
Diviš	muž
Dobromil	muž
Dobroslav	muž
Donald	muž
Dorián	muž
Drahomír	muž
Drahoš	muž
Dušan	muž
Edmond	muž
Edvín	muž
Elizej	muž
Elvis	muž
Emerich	muž
Engelbert	muž
Erhard	muž
Ernest	muž
Eusebius	muž
Evan	muž
Evžen	muž
Ezra	muž
Faust	muž
Felix	muž
Fidel	muž
Filibert	muž
Filomen	muž
Florentýn	muž
Fortunát	muž
Fridolín	muž
Gabriel	muž
Garik	muž
Gedeon	muž
Gerald	muž
Gerazim	muž
Gilbert	muž
Glen	muž
Gordon	muž
Gracián	muž
Gunter	muž
Hanuš	muž
Haštal	muž
Helmut	muž
Heřman	muž
Hjalmar	muž
Honor	muž
Horst	muž
Hostimil	muž
Hostivít	muž
Hubert	muž
Hvězdoslav	muž
Hynek	muž
Chrabroš	muž
Chranislav	muž
Chval	muž
Igor	muž
Inocenc	muž
Irvin	muž
Ivar	muž
Izaiáš	muž
Izidor	muž
Jacek	muž
Jakub	muž
Jarmil	muž
Jaromír	muž
Jasoň	muž
Jeroným	muž
Jimram	muž
Jiří	muž
Jonatan	muž
Josef	muž
Julián	muž
Justýn	muž
Kamil	muž
Kasián	muž
Kašpar	muž
Kilián	muž
Klement	muž
Koloman	muž
Konrád	muž
Kornel	muž
Krasomil	muž
Kristián	muž
Kryštof	muž
Kurt	muž
Květoš	muž
Ladislav	muž
Lazar	muž
Leonard	muž
Leontýn	muž
Leoš	muž
Lev	muž
Liboslav	muž
Livius	muž
Lubomír	muž
Luboš	muž
Luděk	muž
Ludomír	muž
Ludvík	muž
Lukrecius	muž
Lutobor	muž
Makar	muž
Mansvet	muž
Marcel	muž
Marián	muž
Mario	muž
Matěj	muž
Max	muž
Mečislav	muž
Melichar	muž
Mervin	muž
Michal	muž
Milan	muž
Milivoj	muž
Milorad	muž
Miloš	muž
Milouš	muž
Mirek	muž
Miron	muž
Mlad	muž
Mnislav	muž
Mojmír	muž
Morgan	muž
Mstislav	muž
Napoleon	muž
Natan	muž
Něhoslav	muž
Nepomuk	muž
Nikita	muž
Nikola	muž
Norman	muž
Odon	muž
Olaf	muž
Oldřich	muž
Oliver	muž
Ondřej	muž
Oskar	muž
Ota	muž
Otmar	muž
Palmiro	muž
Pantaleon	muž
Parsival	muž
Patrik	muž
Pelhřim	muž
Petr	muž
Pius	muž
Polykarp	muž
Prokop	muž
Přemysl	muž
Radek	muž
Radim	muž
Radmil	muž
Radoslav	muž
Radúz	muž
Raimund	muž
Rainer	muž
Rajko	muž
Ramon	muž
Ranek	muž
Ratmír	muž
Remig	muž
Renát	muž
Richard	muž
Robin	muž
Rodan	muž
Roman	muž
Romuald	muž
Ronald	muž
Ruben	muž
Rufus	muž
Ruslan	muž
Sámo	muž
Samuel	muž
Sebastián	muž
Serafín	muž
Sergej	muž
Severín	muž
Sigfríd	muž
Silvestr	muž
Sinkler	muž
Slávek	muž
Slavoj	muž
Slavomír	muž
Soběslav	muž
Stanimír	muž
Stojan	muž
Svatobor	muž
Svatopluk	muž
Šalomoun	muž
Šimon	muž
Štěpán	muž
Tankred	muž
Teobald	muž
Teodorik	muž
Teofan	muž
Terenc	muž
Tibor	muž
Tichomír	muž
Timon	muž
Timur	muž
Tobiáš	muž
Tomislav	muž
Torsten	muž
Upton	muž
Vadim	muž
Valentýn	muž
Valtr	muž
Vavřinec	muž
Velimír	muž
Vendelín	muž
Věroslav	muž
Viktor	muž
Vilibald	muž
Vincenc	muž
Virgin	muž
Vítězslav	muž
Vivian	muž
Vladimír	muž
Vladivoj	muž
Vlastimír	muž
Vlk	muž
Vojmil	muž
Vojslav	muž
Volfgang	muž
Vsevolod	muž
Všerad	muž
Záboj	muž
Záviš	muž
Zbyněk	muž
Zdeněk	muž
Zdislav	muž
Zikmund	muž
Zlatomír	muž
Zoran	muž
Zosim	muž
Žarko	muž
Želibor	muž
Želislav	muž
Žitoslav	muž
Abigail	žena
Adalberta	žena
Adelaida	žena
Adolfa	žena
Afra	žena
Aglaja	žena
Alana	žena
Alberta	žena
Alena	žena
Alexandra	žena
Alice	žena
Alina	žena
Aloisie	žena
Amálie	žena
Amáta	žena
Anastázie	žena
Anatólie	žena
Andrea	žena
Anežka	žena
Anita	žena
Anselma	žena
Apolena	žena
Aranka	žena
Ariana	žena
Arleta	žena
Arna	žena
Arnoštka	žena
Atanázie	žena
Aurélie	žena
Babeta	žena
Beáta	žena
Bedřiška	žena
Běla	žena
Benedikta	žena
Bernarda	žena
Bertolda	žena
Bibiana	žena
Blahomila	žena
Blahoslava	žena
Blažena	žena
Bohumila	žena
Bohuna	žena
Bojana	žena
Boleslava	žena
Božena	žena
Božidara	žena
Bratislava	žena
Brigita	žena
Bronislava	žena
Brunhilda	žena
Cecílie	žena
Celie	žena
Ctibora	žena
Ctislava	žena
Cyrila	žena
Čestmíra	žena
Dagmar	žena
Dalida	žena
Dalila	žena
Dalimíra	žena
Damiána	žena
Danica	žena
Danuta	žena
Darina	žena
Debora	žena
Denisa	žena
Dina	žena
Diviška	žena
Dobromila	žena
Dobroslava	žena
Donalda	žena
Dora	žena
Doubravka	žena
Drahomíra	žena
Drahuše	žena
Dušana	žena
Eduarda	žena
Ela	žena
Eleonora	žena
Eliška	žena
Elza	žena
Emanuela	žena
Erika	žena
Ervína	žena
Etela	žena
Eulálie	žena
Eusebie	žena
Evelína	žena
Fabie	žena
Faustýna	žena
Fedora	žena
Ferdinanda	žena
Filipa	žena
Flavie	žena
Florentýna	žena
Frída	žena
Gaja	žena
Garika	žena
Geralda	žena
Gerda	žena
Gilberta	žena
Gita	žena
Glorie	žena
Grácie	žena
Gréta	žena
Gudrun	žena
Gvendolína	žena
Hana	žena
Havla	žena
Hedvika	žena
Helena	žena
Herberta	žena
Herta	žena
Hortenzie	žena
Hostimila	žena
Hvězdoslava	žena
Chranislava	žena
Ida	žena
Ildika	žena
Ilona	žena
Inéz	žena
Ingrid	žena
Irena	žena
Irma	žena
Ivana	žena
Ivona	žena
Izidora	žena
Jadrana	žena
Jana	žena
Jarolíma	žena
Jaroslava	žena
Jasna	žena
Jenovéfa	žena
Jindra	žena
Jiřina	žena
Jolana	žena
Jordana	žena
Josefa	žena
Judita	žena
Julie	žena
Juta	žena
Karin	žena
Karmela	žena
Karolína	žena
Katrin	žena
Kazimíra	žena
Klára	žena
Klementýna	žena
Klotylda	žena
Kolombína	žena
Konzuela	žena
Kordula	žena
Krasava	žena
Kristýna	žena
Květa	žena
Lada	žena
Larisa	žena
Laurencie	žena
Léda	žena
Lenka	žena
Leona	žena
Leopolda	žena
Liběna	žena
Liboslava	žena
Liliana	žena
Linda	žena
Ljuba	žena
Loreta	žena
Lota	žena
Lucie	žena
Luďka	žena
Ludomíra	žena
Ludvíka	žena
Lukrécie	žena
Lýdie	žena
Magda	žena
Mahulena	žena
Malvína	žena
Manuela	žena
Margit	žena
Marie	žena
Marika	žena
Marina	žena
Marion	žena
Marita	žena
Marlena	žena
Martina	žena
Maud	žena
Mečislava	žena
Melánie	žena
Melisa	žena
Michaela	žena
Milana	žena
Miloslava	žena
Miluše	žena
Mirabela	žena
Mirela	žena
Mirka	žena
Miroslava	žena
Mona	žena
Muriel	žena
Naďa	žena
Naneta	žena
Natálie	žena
Neda	žena
Nevena	žena
Nikodéma	žena
Nila	žena
Noema	žena
Nora	žena
Norma	žena
Ofélie	žena
Oldřiška	žena
Olivie	žena
Ondřejka	žena
Otýlie	žena
Palmira	žena
Paskala	žena
Pavla	žena
Penelopa	žena
Perzida	žena
Petronela	žena
Pilar	žena
Pravomila	žena
Pravoslava	žena
Prokopa	žena
Radana	žena
Radmila	žena
Radoslava	žena
Ráchel	žena
Ramona	žena
Regína	žena
René	žena
Richarda	žena
Rita	žena
Robina	žena
Rostislava	žena
Roxana	žena
Rozálie	žena
Rozamunda	žena
Rozina	žena
Rozvita	žena
Rut	žena
Růžena	žena
Sabina	žena
Salomea	žena
Sandra	žena
Saskie	žena
Selena	žena
Senta	žena
Serena	žena
Sibyla	žena
Silvána	žena
Simona	žena
Slavěna	žena
Slavomila	žena
Soběslava	žena
Solveig	žena
Sotira	žena
Stáza	žena
Svatava	žena
Světla	žena
Šárka	žena
Šimona	žena
Tamara	žena
Taťána	žena
Tekla	žena
Teodozie	žena
Tereza	žena
Toska	žena
Una	žena
Václava	žena
Valdemara	žena
Valérie	žena
Vanesa	žena
Veleslava	žena
Vendelína	žena
Venuše	žena
Veronika	žena
Vesna	žena
Vilma	žena
Viola	žena
Víta	žena
Viviana	žena
Vladimíra	žena
Vlasta	žena
Vlastimíra	žena
Vojmíra	žena
Vojtěška	žena
Vratislava	žena
Xenie	žena
Zaira	žena
Zbyslava	žena
Zdislava	žena
Zina	žena
Zlata	žena
Zoe	žena
Zoroslava	žena
Zvonimíra	žena
Žaneta	žena
Želimíra	žena
Žitomíra	žena
Žofie	žena
Ada	žena
Adéla	žena
Adina	žena
Adriana	žena
Agáta	žena
Aida	žena
Albena	žena
Albína	žena
Aleška	žena
Alfréda	žena
Alida	žena
Alma	žena
Alžběta	žena
Amanda	žena
Anabela	žena
Anatázie	žena
Anděla	žena
Aneta	žena
Angelika	žena
Anna	žena
Antonie	žena
Arabela	žena
Areta	žena
Ariela	žena
Armida	žena
Arnolda	žena
Astrid	žena
Augusta	žena
Aurora	žena
Barbora	žena
Beatrice	žena
Bela	žena
Belinda	žena
Berenika	žena
Berta	žena
Bianka	žena
Birgit	žena
Blahomíra	žena
Blanka	žena
Bohdana	žena
Bohumíra	žena
Bohuslava	žena
Bojislava	žena
Bořislava	žena
Božetěcha	žena
Branimíra	žena
Brenda	žena
Brita	žena
Bruna	žena
Břetislava	žena
Celestýna	žena
Celina	žena
Ctirada	žena
Cyntie	žena
Čeňka	žena
Čistoslava	žena
Dalibora	žena
Dalie	žena
Dalimila	žena
Damaris	žena
Dana	žena
Daniela	žena
Darie	žena
Davida	žena
Delie	žena
Diana	žena
Dita	žena
Dobrava	žena
Dobromíra	žena
Dominika	žena
Donáta	žena
Doris	žena
Drahomila	žena
Drahoslava	žena
Dulcinea	žena
Edita	žena
Egona	žena
Elektra	žena
Elfrída	žena
Elvíra	žena
Ema	žena
Emílie	žena
Erna	žena
Ester	žena
Eufrozína	žena
Eunika	žena
Eva	žena
Evženie	žena
Fatima	žena
Féba	žena
Felicita	žena
Fidelie	žena
Filoména	žena
Flóra	žena
Františka	žena
Gabriela	žena
Galina	žena
Gema	žena
Gerarda	žena
Gertruda	žena
Gina	žena
Gizela	žena
Gordana	žena
Gražina	žena
Grizelda	žena
Gustava	žena
Halina	žena
Háta	žena
Heda	žena
Heidrun	žena
Helga	žena
Hermína	žena
Hilda	žena
Horymíra	žena
Hostislava	žena
Hyacinta	žena
Iboja	žena
Ignácie	žena
Iljana	žena
Ilza	žena
Ingeborg	žena
Inka	žena
Iris	žena
Iva	žena
Iveta	žena
Izabela	žena
Izolda	žena
Jakubka	žena
Jarmila	žena
Jaromíra	žena
Jasmína	žena
Jelena	žena
Jesika	žena
Jindřiška	žena
Jitka	žena
Jolanta	žena
Jorga	žena
Jovana	žena
Juliána	žena
Justýna	žena
Kamila	žena
Karla	žena
Karmen	žena
Kateřina	žena
Kazi	žena
Kira	žena
Klaudie	žena
Kleopatra	žena
Koleta	žena
Konstance	žena
Kora	žena
Kornélie	žena
Krasomila	žena
Kunhuta	žena
Květoslava	žena
Ladislava	žena
Laura	žena
Lea	žena
Lejla	žena
Leokádie	žena
Leontýna	žena
Leticie	žena
Libora	žena
Libuše	žena
Lina	žena
Livie	žena
Lola	žena
Lorna	žena
Lubomíra	žena
Ludiše	žena
Ludmila	žena
Ludoslava	žena
Lujza	žena
Lumíra	žena
Mabel	žena
Magdaléna	žena
Mája	žena
Manon	žena
Marcela	žena
Mariana	žena
Marieta	žena
Marilyn	žena
Mariola	žena
Marisa	žena
Markéta	žena
Marta	žena
Matylda	žena
Maxima	žena
Médea	žena
Melinda	žena
Mercedes	žena
Milada	žena
Milena	žena
Milred	žena
Mína	žena
Miranda	žena
Miriam	žena
Miromila	žena
Mnislava	žena
Monika	žena
Myrna	žena
Naděžda	žena
Narcisa	žena
Nataša	žena
Nela	žena
Nika	žena
Nikol	žena
Nina	žena
Nona	žena
Norberta	žena
Odeta	žena
Oktávie	žena
Olga	žena
Olympie	žena
Otakara	žena
Oxana	žena
Pamela	žena
Patricie	žena
Pelagie	žena
Perla	žena
Petra	žena
Petula	žena
Polyxena	žena
Pravoslav	žena
Priska	žena
Přibyslava	žena
Radka	žena
Radomíra	žena
Rafaela	žena
Rajsa	žena
Rebeka	žena
Renáta	žena
Ria	žena
Rina	žena
Roberta	žena
Romana	žena
Rovena	žena
Róza	žena
Rozalinda	žena
Rozana	žena
Rozita	žena
Rudolfa	žena
Rút	žena
Řehořka	žena
Sabrina	žena
Samuela	žena
Sára	žena
Saxona	žena
Selma	žena
Serafína	žena
Scholastika	žena
Sidonie	žena
Silvie	žena
Skarlet	žena
Slávka	žena
Slavomíra	žena
Sofronie	žena
Soňa	žena
Stanislava	žena
Stela	žena
Svatoslava	žena
Sylva	žena
Šarlota	žena
Štěpánka	žena
Táňa	žena
Tea	žena
Teodora	žena
Teofila	žena
Tomáška	žena
Ulrika	žena
Uršula	žena
Valburga	žena
Valentýna	žena
Vanda	žena
Věduna	žena
Věnceslava	žena
Vendula	žena
Věra	žena
Věroslava	žena
Viktorie	žena
Vincencie	žena
Virgínie	žena
Vítězslava	žena
Vladana	žena
Vladislava	žena
Vlastimila	žena
Vlastislava	žena
Vojslava	žena
Voršila	žena
Xaverie	žena
Zaida	žena
Zbyhněva	žena
Zdeňka	žena
Zenobie	žena
Zita	žena
Zlatomíra	žena
Zora	žena
Zuzana	žena
Žakelína	žena
Ždana	žena
Želislava	žena
Živa	žena