NOVÁKOVÁ	žena
NOVÁK	žena
SVOBODOVÁ	žena
SVOBODA	muž
NOVOTNÁ	žena
NOVOTNÝ	muž
DVOŘÁKOVÁ	žena
DVOŘÁK	muž
ČERNÁ	žena
ČERNÝ	muž
PROCHÁZKOVÁ	žena
PROCHÁZKA	muž
KUČEROVÁ	žena
KUČERA	muž
VESELÁ	žena
VESELÝ	muž
NGUYEN	muž
HORÁKOVÁ	žena
HORÁK	muž
KREJČÍ	muž
NĚMEC	muž
NĚMCOVÁ	žena
MARKOVÁ	žena
POKORNÁ	žena
MAREK	muž
POSPÍŠILOVÁ	žena
POSPÍŠIL	muž
POKORNÝ	muž
HÁJKOVÁ	žena
HÁJEK	muž
JELÍNKOVÁ	žena
KRÁLOVÁ	žena
JELÍNEK	muž
KRÁL	muž
BENEŠOVÁ	žena
RŮŽIČKA	muž
RŮŽIČKOVÁ	žena
BENEŠ	muž
FIALOVÁ	žena
FIALA	muž
SEDLÁČKOVÁ	žena
ZEMAN	muž
SEDLÁČEK	muž
DOLEŽAL	muž
DOLEŽALOVÁ	žena
ZEMANOVÁ	žena
KOLÁŘOVÁ	žena
KOLÁŘ	muž
ČERMÁKOVÁ	žena
NAVRÁTIL	muž
ČERMÁK	muž
NAVRÁTILOVÁ	žena
URBAN	muž
VAŇKOVÁ	žena
URBANOVÁ	žena
VANĚK	muž
KRATOCHVÍLOVÁ	žena
BLAŽKOVÁ	žena
BLAŽEK	muž
ŠIMKOVÁ	žena
KŘÍŽOVÁ	žena
KŘÍŽ	muž
KOPECKÁ	žena
KRATOCHVÍL	muž
KOVÁŘ	žena
BARTOŠOVÁ	žena
VLČKOVÁ	žena
BARTOŠ	muž
KOVÁŘOVÁ	žena
KOPECKÝ	muž
POLÁKOVÁ	žena
VLČEK	muž
ŠIMEK	muž
POLÁK	muž
MALÁ	žena
ČECHOVÁ	žena
MALÝ	muž
MUSIL	muž
MUSILOVÁ	žena
KONEČNÁ	žena
KONEČNÝ	muž
HOLUBOVÁ	žena
HOLUB	muž
ČECH	muž
STAŇKOVÁ	žena
KADLECOVÁ	žena
ŠTĚPÁNKOVÁ	žena
KADLEC	muž
ŠTĚPÁNEK	muž
STANĚK	muž
DOSTÁLOVÁ	žena
SOUKUPOVÁ	žena
ŠŤASTNÁ	žena
DOSTÁL	muž
SOUKUP	muž
ŠŤASTNÝ	muž
MAREŠOVÁ	žena
TICHÁ	žena
SÝKOROVÁ	žena
MAREŠ	muž
SÝKORA	muž
KREJČOVÁ	žena
MORAVEC	muž
TICHÝ	muž
VALENTOVÁ	žena
MORAVCOVÁ	žena
BLÁHOVÁ	žena
VÁVROVÁ	žena
VALENTA	muž
MAŠKOVÁ	žena
BLÁHA	muž
VÁVRA	muž
ŘÍHOVÁ	žena
MATOUŠKOVÁ	žena
MATOUŠEK	muž
ŘÍHA	muž
MACHOVÁ	žena
ŠEVČÍKOVÁ	žena
ŠEVČÍK	muž
BUREŠOVÁ	žena
BUREŠ	muž
DUŠKOVÁ	žena
ŠMÍDOVÁ	žena
HRUŠKA	muž
MAŠEK	muž
JANDOVÁ	žena
HRUŠKOVÁ	žena
HRUBÁ	žena
PAVLÍKOVÁ	žena
DUŠEK	muž
PAVLÍK	muž
JANDA	muž
HRUBÝ	muž
HAVLÍČEK	muž
HAVLÍČKOVÁ	žena
MACH	muž
BERANOVÁ	žena
BERAN	muž
LIŠKA	muž
LIŠKOVÁ	žena
MÜLLER	muž
VACKOVÁ	žena
BEDNÁŘ	muž
TŮMOVÁ	žena
BÁRTA	muž
BÁRTOVÁ	žena
VACEK	muž
KAŠPAROVÁ	žena
BEDNÁŘOVÁ	žena
ŠMÍD	muž
ŽÁKOVÁ	žena
SEDLÁK	muž
TOMANOVÁ	žena
TOMAN	muž
ŠVEC	muž
MACHÁČKOVÁ	žena
MACHÁČEK	muž
TŮMA	muž
KAŠPAR	muž
VÍTEK	muž
FIŠEROVÁ	žena
ŽÁK	muž
VÍTKOVÁ	žena
SEDLÁKOVÁ	žena
JAROŠOVÁ	žena
ŠVECOVÁ	žena
JANEČKOVÁ	žena
PEŠKOVÁ	žena
STEJSKALOVÁ	žena
MÜLLEROVÁ	žena
STEJSKAL	muž
JEŽKOVÁ	žena
JAROŠ	muž
SLAVÍKOVÁ	žena
MATĚJKOVÁ	žena
BÍLEK	muž
BÍLKOVÁ	žena
STRNAD	muž
KRAUSOVÁ	žena
SLAVÍK	muž
JEŽEK	muž
BERÁNKOVÁ	žena
STRNADOVÁ	žena
NĚMEČEK	muž
NĚMEČKOVÁ	žena
HORÁČKOVÁ	žena
KOČÍ	muž
BERÁNEK	muž
HORVÁTH	muž
BROŽOVÁ	žena
HORÁČEK	muž
KRAUS	muž
FIŠER	muž
TESAŘ	muž
MATĚJKA	muž
BROŽ	muž
TESAŘOVÁ	žena
HAVLOVÁ	žena
KUBÍČEK	muž
KOHOUT	muž
KUBÍČKOVÁ	žena
PETROVÁ	žena
PROKOP	muž
KOHOUTOVÁ	žena
HAVEL	muž
PROKOPOVÁ	žena
RICHTER	muž
PAVLÍČKOVÁ	žena
PAVELKOVÁ	žena
HAVLÍK	muž
KLÍMA	muž
ŠULCOVÁ	žena
JANEČEK	muž
ŠULC	muž
SOUČKOVÁ	žena
PAVLÍČEK	muž
KLÍMOVÁ	žena
SUCHÝ	muž
HAVLÍKOVÁ	žena
ČÍŽKOVÁ	žena
PEŠEK	muž
JANOUŠKOVÁ	žena
STRAKA	muž
ČÍŽEK	muž
JANOUŠEK	muž
SOUČEK	muž
STRAKOVÁ	žena
TOMÁŠKOVÁ	žena
SUCHÁ	žena
PETR	muž
HORVÁTHOVÁ	žena
HAVELKOVÁ	žena
ŠPAČKOVÁ	žena
PECHOVÁ	žena
KOVAŘÍKOVÁ	žena
ŠPAČEK	muž
FILIP	muž
TRAN	muž
KOVAŘÍK	muž
ADÁMKOVÁ	žena
JEDLIČKA	muž
KOZÁKOVÁ	žena
KOZÁK	muž
ČERVENKOVÁ	žena
HLAVÁČKOVÁ	žena
JEDLIČKOVÁ	žena
DAŇKOVÁ	žena
FILIPOVÁ	žena
URBÁNEK	muž
HLAVÁČEK	muž
RICHTEROVÁ	žena
MRÁZKOVÁ	žena
ADÁMEK	muž
ČERVENKA	muž
HAVELKA	muž
ZAPLETALOVÁ	žena
TOMÁŠEK	muž
URBÁNKOVÁ	žena
JEŘÁBKOVÁ	žena
JEŘÁBEK	muž
MRÁZEK	muž
ZAPLETAL	muž
PŘIBYLOVÁ	žena
HANÁK	muž
BENDOVÁ	žena
ŠTĚPÁNOVÁ	žena
VRBA	muž
HOLÝ	muž
ČAPKOVÁ	žena
DANĚK	muž
STEHLÍK	muž
PŘIBYL	muž
KUBÍK	muž
VRBOVÁ	žena
MACKOVÁ	žena
MÁLEK	muž
BENDA	muž
ŠTĚPÁN	muž
HANÁKOVÁ	žena
KUBÍKOVÁ	žena
HLADÍK	muž
HOLÁ	žena
STEHLÍKOVÁ	žena
HRDLIČKOVÁ	žena
KOVÁČ	žena
VLKOVÁ	žena
HRDLIČKA	muž
NOVÁ	žena
MICHÁLKOVÁ	žena
ŠINDELÁŘOVÁ	žena
MÁLKOVÁ	žena
MICHÁLEK	muž
VLK	muž
PAVELKA	muž
DVOŘÁČEK	muž
JANKŮ	muž
ADAMCOVÁ	žena
ŠINDELÁŘ	muž
VÁŇOVÁ	žena
NOVÝ	muž
HLADÍKOVÁ	žena
VOLF	muž
ADAMEC	muž
LINHART	muž
DVOŘÁČKOVÁ	žena
VOLFOVÁ	žena
LINHARTOVÁ	žena
BRABEC	muž
KLIMEŠOVÁ	žena
ŠRÁMKOVÁ	žena
ZELENKOVÁ	žena
BRABCOVÁ	žena
ŘEHÁKOVÁ	žena
KLIMEŠ	muž
ZELENKA	muž
TURKOVÁ	žena
ŘEHÁK	muž
VRÁNA	muž
VRÁNOVÁ	žena
ŠRÁMEK	muž
BŘEZINA	muž
VÁŇA	muž
HLAVÁČ	muž
BŘEZINOVÁ	žena
HLAVÁČOVÁ	žena
KOŘÍNKOVÁ	žena
KOŘÍNEK	muž
TUREK	muž
ŘEZNÍČEK	muž
MARTÍNEK	muž
CHARVÁTOVÁ	žena
CHARVÁT	muž
KRÁTKÝ	muž
VÁLKOVÁ	žena
KOVÁČOVÁ	žena
JÍLEK	muž
DAVID	muž
JÍLKOVÁ	žena
DAVIDOVÁ	žena
MACEK	muž
SUCHÁNEK	muž
KRÁTKÁ	žena
TRNKA	muž
DLOUHÁ	žena
ŘEZNÍČKOVÁ	žena
SLÁMA	muž
MARTÍNKOVÁ	žena
POLÁŠEK	muž
SLÁMOVÁ	žena
HOLEČKOVÁ	žena
NOVÁČEK	žena
POLÁŠKOVÁ	žena
TRNKOVÁ	žena
STRÁNSKÁ	žena
SUCHÁNKOVÁ	žena
DLOUHÝ	muž
BURIAN	muž
SLÁDKOVÁ	žena
NOVÁČKOVÁ	žena
HOŠKOVÁ	žena
ČAPEK	muž
BURIANOVÁ	žena
PTÁČKOVÁ	žena
STRÁNSKÝ	muž
PTÁČEK	muž
HOLEČEK	muž
NOSKOVÁ	žena
SLÁDEK	muž
ŠÍMOVÁ	žena
LUKEŠ	muž
DOHNAL	muž
ŠÍMA	muž
HOŠEK	muž
POLÁČEK	muž
HANUŠ	muž
HANUŠOVÁ	žena
KROUPA	muž
LUKEŠOVÁ	žena
MALÍKOVÁ	žena
PHAM	muž
DOHNALOVÁ	žena
MALÍK	muž
KROUPOVÁ	žena
KOMÁRKOVÁ	žena
SOBOTKA	muž
VAŠÍČEK	muž
ŠVARC	muž
ŠVARCOVÁ	žena
VAŠÍČKOVÁ	žena
KOMÁREK	muž
CHALOUPKOVÁ	žena
KUBÁT	muž
KUBÁTOVÁ	žena
VODIČKA	muž
VODIČKOVÁ	žena
DUFKOVÁ	žena
GREGOROVÁ	žena
JIRÁSKOVÁ	žena
VAŠKOVÁ	žena
VLACH	muž
NOSEK	muž
VÁLEK	muž
TOMKOVÁ	žena
POLÁČKOVÁ	žena
ŠEBESTOVÁ	žena
MRÁZ	muž
ŠEBESTA	muž
ŠEDIVÝ	muž
LE	muž
GREGOR	muž
VLACHOVÁ	žena
MRÁZOVÁ	žena
SOBOTKOVÁ	žena
ŠEDIVÁ	žena
ZAJÍČEK	muž
FOJTÍK	muž
SMETANOVÁ	žena
SLEZÁK	muž
ŽÁČKOVÁ	žena
SMETANA	muž
KUCHAŘ	muž
STARÝ	muž
PROKEŠ	muž
PROKEŠOVÁ	žena
ZAJÍČKOVÁ	žena
SLEZÁKOVÁ	žena
KALINOVÁ	žena
STARÁ	žena
KUCHAŘOVÁ	žena
KALINA	muž
ČERVENÝ	muž
FOJTÍKOVÁ	žena
KOPŘIVA	muž
ŽÁČEK	muž
DUFEK	muž
PETERKOVÁ	žena
BURDA	muž
CHALOUPKA	muž
ČERVENÁ	žena
BURDOVÁ	žena
BARTOŇ	muž
SIKORA	muž
KOPŘIVOVÁ	žena
MIKEŠ	muž
KARÁSKOVÁ	žena
MAJEROVÁ	žena
KOUDELKA	muž
KARÁSEK	muž
VLASÁK	muž
BAUER	muž
VLASÁKOVÁ	žena
MAJER	muž
VONDRÁČKOVÁ	žena
MIKEŠOVÁ	žena
HOFMANOVÁ	žena
PŘIKRYLOVÁ	žena
DUDA	muž
ADAM	muž
KOUDELKOVÁ	žena
VONDRÁČEK	muž
HUDEC	muž
HOFMAN	muž
PÁNKOVÁ	žena
PŘIKRYL	muž
ADAMOVÁ	žena
BOHÁČOVÁ	žena
ŠEBEK	muž
BOHÁČ	muž
ŠEBKOVÁ	žena
PÁNEK	muž
BARTOŇOVÁ	žena
HORKÝ	muž
MARTINKOVÁ	žena
DIVIŠ	muž
BALÁŽ	muž
ŠTĚRBA	muž
KOUBA	muž
VÁCLAVÍK	muž
DUDOVÁ	žena
ŠTĚRBOVÁ	žena
CHALUPOVÁ	žena
ONDRÁČEK	muž
KOUBOVÁ	žena
KOCOUREK	muž
CHALUPA	muž
HORKÁ	žena
ONDRÁČKOVÁ	žena
HAVRÁNKOVÁ	žena
KUNCOVÁ	žena
JINDRA	muž
KUNC	muž
PETŘÍKOVÁ	žena
RADOVÁ	žena
KOCOURKOVÁ	žena
JINDROVÁ	žena
DOLEŽEL	muž
SIKOROVÁ	žena
VEČEŘOVÁ	žena
PETŘÍK	muž
BAUEROVÁ	žena
RADA	muž
JIRÁSEK	muž
DIVIŠOVÁ	žena
ZAJÍC	muž
ZAJÍCOVÁ	žena
UHLÍŘ	muž
COUFAL	muž
HAVRÁNEK	muž
DOLEŽELOVÁ	žena
VÁCLAVÍKOVÁ	žena
UHLÍŘOVÁ	žena
KOČOVÁ	žena
TOMEK	muž
ZAHRADNÍK	muž
PECH	muž
BERKOVÁ	žena
KVAPILOVÁ	žena
TRÁVNÍČEK	muž
MINAŘÍK	muž
KVAPIL	muž
DOLEJŠÍ	muž
MINAŘÍKOVÁ	žena
MIKOVÁ	žena
VAŠEK	muž
SKÁLA	muž
ZAVADIL	muž
SKÁLOVÁ	žena
KULHÁNEK	muž
ZAHRADNÍKOVÁ	žena
KŘÍŽKOVÁ	žena
COUFALOVÁ	žena
HOVORKOVÁ	žena
KULHÁNKOVÁ	žena
BARTÁKOVÁ	žena
BÍLÝ	muž
PETRŮ	muž
TRÁVNÍČKOVÁ	žena
ČEJKOVÁ	žena
ŠKODA	muž
LANGER	muž
BARTÁK	muž
ZAVADILOVÁ	žena
HOVORKA	muž
PETERKA	muž
FRANKOVÁ	žena
MAREČKOVÁ	žena
VANÍČKOVÁ	žena
BERKA	muž
LUKÁŠ	muž
ŽIŽKOVÁ	žena
VEČEŘA	muž
MAREČEK	muž
ŠKODOVÁ	žena
TUČKOVÁ	žena
MELICHAR	muž
UHER	muž
VANÍČEK	muž
ŽIŽKA	muž
KŘIVÁNKOVÁ	žena
MARTINEK	muž
FORMÁNEK	muž
ČEJKA	muž
MELICHAROVÁ	žena
KŘIVÁNEK	muž
HAMPLOVÁ	žena
DRÁBEK	muž
BÍLÁ	žena
HANZLÍKOVÁ	žena
FRANCOVÁ	žena
FORMÁNKOVÁ	žena
NEUMANN	muž
DRÁBKOVÁ	žena
BALÁŽOVÁ	žena
LUKÁŠOVÁ	žena
HANZLÍK	muž
ČERVINKOVÁ	žena
VÍTOVÁ	žena
KUBEŠOVÁ	žena
FRANC	muž
ŘEZÁČOVÁ	žena
HUBÁČEK	muž
KOZEL	muž
ŠIMON	muž
SMEJKAL	muž
TUČEK	muž
KOCIÁN	muž
PELIKÁN	muž
TROJANOVÁ	žena
NEUMANNOVÁ	žena
UHROVÁ	žena
ŠIMONOVÁ	žena
VÁCHOVÁ	žena
KOCIÁNOVÁ	žena
SMEJKALOVÁ	žena
BALOG	muž
ZATLOUKAL	muž
SKLENÁŘOVÁ	žena
KOZLOVÁ	žena
ŘEZÁČ	muž
TROJAN	muž
HAMPL	muž
KOS	muž
SIVÁK	muž
PELIKÁNOVÁ	žena
KŘÍŽEK	muž
ČERVINKA	muž
KOUTNÝ	muž
SKLENÁŘ	muž
KOSOVÁ	žena
DOBEŠ	muž
KUPKOVÁ	žena
KOŠŤÁL	muž
MORÁVKOVÁ	žena
DOBEŠOVÁ	žena
LANG	muž
HOROVÁ	žena
ZATLOUKALOVÁ	žena
SCHNEIDER	muž
ŠUBRTOVÁ	žena
HUBÁČKOVÁ	žena
KUPKA	muž
HORA	muž
VÁCHA	muž
KOUTNÁ	žena
KOŠŤÁLOVÁ	žena
KUBÍNOVÁ	žena
MORÁVEK	muž
VEVERKA	muž
MALINA	muž
BLAHOVÁ	žena
HRADIL	muž
NEČAS	muž
NEČASOVÁ	žena
KUBÍN	muž
ŠUBRT	muž
BOČEK	muž
VÍT	muž
SEIDLOVÁ	žena
SMOLÍKOVÁ	žena
VEVERKOVÁ	žena
VÁGNER	muž
HRDINA	muž
KOLAŘÍKOVÁ	žena
HRADILOVÁ	žena
JANÍK	muž
POPELKA	muž
HOUDEK	muž
KUBOVÁ	žena
MATUŠKOVÁ	žena
SMOLÍK	muž
HOUDKOVÁ	žena
BOČKOVÁ	žena
JONÁŠ	muž
VU	muž
VÁGNEROVÁ	žena
HUDCOVÁ	žena
MALINOVÁ	žena
SAMKOVÁ	žena
SOCHOROVÁ	žena
KUBEŠ	muž
KOLAŘÍK	muž
LORENC	muž
HRDINOVÁ	žena
KAFKA	muž
MARTINEC	muž
VALOVÁ	žena
ELIÁŠ	muž
BUCHTA	muž
ELIÁŠOVÁ	žena
JANÍKOVÁ	žena
SEIDL	muž
MARTINCOVÁ	žena
LANGOVÁ	žena
ČÁPOVÁ	žena
RYŠAVÝ	muž
ČÁP	muž
PEKÁREK	muž
ŠAFRÁNKOVÁ	žena
KAFKOVÁ	žena
ŠIMŮNKOVÁ	žena
POPELKOVÁ	žena
JONÁŠOVÁ	žena
RYŠAVÁ	žena
SKALICKÁ	žena
ŠAFRÁNEK	muž
PEKÁRKOVÁ	žena
POLÍVKA	muž
ŠTEFKOVÁ	žena
POLÍVKOVÁ	žena
VALÁŠEK	muž
PRAŽÁKOVÁ	žena
PRAŽÁK	muž
SKALICKÝ	muž
HLOUŠEK	muž
MUCHA	muž
BUCHTOVÁ	žena
HLOUŠKOVÁ	žena
BALOGOVÁ	žena
VACULÍK	muž
LORENCOVÁ	žena
BLAHA	muž
SIVÁKOVÁ	žena
ŠIMŮNEK	muž
PRŮŠA	muž
GÁBOR	muž
KLEIN	muž
JANÍČEK	muž
MAŘÍKOVÁ	žena
LACINA	muž
VALÁŠKOVÁ	žena
BUČKOVÁ	žena
KŘENEK	muž
KRÁLÍK	muž
PRŮŠOVÁ	žena
JANÍČKOVÁ	žena
JANŮ	muž
VYSKOČIL	muž
NEJEDLÁ	žena
SOCHOR	muž
BÖHM	muž
NEDVĚD	muž
NEJEDLÝ	muž
SMUTNÝ	muž
LANGEROVÁ	žena
ŠMEJKALOVÁ	žena
MAŘÍK	muž
VACULÍKOVÁ	žena
SMUTNÁ	žena
ZELENÝ	muž
ZEMÁNEK	muž
FISCHER	muž
NEDVĚDOVÁ	žena
HOŘEJŠÍ	muž
VYSKOČILOVÁ	žena
ŠMEJKAL	muž
PLACHÁ	žena
ZELINKA	muž
KŘENKOVÁ	žena
PAVLŮ	muž
ZELINKOVÁ	žena
VALA	muž
HUDEČEK	muž
MUCHOVÁ	žena
LACINOVÁ	žena
KOSTKOVÁ	žena
CHLÁDKOVÁ	žena
BAREŠ	muž
HUDEČKOVÁ	žena
BAREŠOVÁ	žena
ČERVEŇÁK	muž
PLACHÝ	muž
WOLF	muž
VANĚČKOVÁ	žena
KARAS	muž
BÖHMOVÁ	žena
KRÁLÍKOVÁ	žena
SAMEK	muž
HOLÍK	muž
ZELENÁ	žena
KOSTKA	muž
BRÁZDOVÁ	žena
BRÁZDA	muž
DEMETER	muž
KARASOVÁ	žena
ČONKA	muž
HOMOLKA	muž
SCHNEIDEROVÁ	žena
ZEMÁNKOVÁ	žena
CHLÁDEK	muž
HOMOLA	muž
KLEINOVÁ	žena
DOČKAL	muž
KUBA	muž
ŠESTÁKOVÁ	žena
VOTAVA	muž
DOUBEK	muž
JIRKŮ	muž
HLAVATÁ	žena
PILAŘ	muž
HYNKOVÁ	žena
ŠESTÁK	muž
HUSÁKOVÁ	žena
SOKOLOVÁ	žena
HOMOLOVÁ	žena
HUSÁK	muž
SOJKA	muž
HOLÍKOVÁ	žena
SCHWARZ	muž
DOUBKOVÁ	žena
MIKULOVÁ	žena
MŰLLER	muž
MENŠÍK	muž
VOTAVOVÁ	žena
HERMAN	muž
SOJKOVÁ	žena
JAKUBEC	muž
VERNER	muž
MŰLLEROVÁ	žena
TOMÁNEK	muž
KOUBKOVÁ	žena
DOČKALOVÁ	žena
VANĚČEK	muž
HYNEK	muž
KOUBEK	muž
DANIEL	muž
HLAVATÝ	muž
PECHA	muž
LUDVÍK	muž
PRCHALOVÁ	žena
MATULA	muž
VONDRA	muž
ČERVEŇÁKOVÁ	žena
PILAŘOVÁ	žena
STUCHLÍK	muž
ANTOŠOVÁ	žena
ANTOŠ	muž
PLAČKOVÁ	žena
HERMANOVÁ	žena
PRCHAL	muž
MENŠÍKOVÁ	žena
VONDROVÁ	žena
HOMOLKOVÁ	žena
SOKOL	muž
FISCHEROVÁ	žena
FERENC	muž
ZIMA	muž
VARGA	muž
KAŠPÁREK	muž
HAŠKOVÁ	žena
MATULOVÁ	žena
JAKUBCOVÁ	žena
ZIMOVÁ	žena
CHOVANEC	muž
TOMÁNKOVÁ	žena
GABRIEL	muž
KOLÁČEK	muž
STUCHLÍKOVÁ	žena
MATUŠKA	muž
VERNEROVÁ	žena
SLABÝ	muž
ŠIMEČKOVÁ	žena
GÁBOROVÁ	žena
HÁLOVÁ	žena
CHYTILOVÁ	žena
PLAČEK	muž
WAGNER	muž
VOJTOVÁ	žena
KOHOUTKOVÁ	žena
KOLÁČKOVÁ	žena
ZBOŘIL	muž
HÁLA	muž
KOTKOVÁ	žena
VOJÁČEK	muž
BUČEK	muž
GABRIELOVÁ	žena
KUDRNOVÁ	žena
JANOVSKÁ	žena
KOHOUTEK	muž
FRANK	muž
JANOVSKÝ	muž
KOTEK	muž
MIKULA	muž
KLEMENTOVÁ	žena
KOUŘIL	muž
CÍSAŘOVÁ	žena
VALEŠ	muž
KUDRNA	muž
ŠIMEČEK	muž
KAŠPÁRKOVÁ	žena
MACHALA	muž
VOJTA	muž
SMRČKOVÁ	žena
WOLFOVÁ	žena
ZÁMEČNÍK	muž
LUDVÍKOVÁ	žena
ZBOŘILOVÁ	žena
CHYTIL	muž
CÍSAŘ	muž
DOLEJŠOVÁ	žena
KLEMENT	muž
SLABÁ	žena
DOLEJŠ	muž
CHOVANCOVÁ	žena
KOUŘILOVÁ	žena
BEZDĚKOVÁ	žena
DUDEK	muž
MARŠÁLKOVÁ	žena
ČIHÁKOVÁ	žena
SLAVÍČKOVÁ	žena
HRONOVÁ	žena
FRAŇKOVÁ	žena
KRUPIČKA	muž
VOJÁČKOVÁ	žena
VALEŠOVÁ	žena
ZÁRUBA	muž
MACHALOVÁ	žena
ŠNAJDROVÁ	žena
SLAVÍČEK	muž
POLÁCH	muž
DUDKOVÁ	žena
DEMETEROVÁ	žena
HOANG	muž
HRON	muž
JAVŮREK	muž
CIBULKA	muž
PAŘÍZEK	muž
KRUPIČKOVÁ	žena
MUŽÍK	muž
DANIELOVÁ	žena
MARŠÁLEK	muž
SCHMIDT	muž
ČIHÁK	muž
SLOVÁK	žena
KREJČÍK	muž
FRANĚK	muž
RAŠKOVÁ	žena
PAŘÍZKOVÁ	žena
ŠOLC	muž
BROŽKOVÁ	žena
POLÁCHOVÁ	žena
MÍKOVÁ	žena
PRŮCHOVÁ	žena
SCHWARZOVÁ	žena
ZÁRUBOVÁ	žena
SPÁČIL	muž
TOMÁŠ	muž
NGUYENOVÁ	žena
ZÁMEČNÍKOVÁ	žena
DUBSKÝ	muž
HORVÁT	muž
PRŮCHA	muž
ŠAFÁŘOVÁ	žena
ŠNAJDR	muž
KREJČÍKOVÁ	žena
BLECHA	muž
VYBÍRAL	muž
MUŽÍKOVÁ	žena
POSPÍCHAL	muž
BEZDĚK	muž
JAVŮRKOVÁ	žena
SLOVÁKOVÁ	žena
ŠAFÁŘ	muž
HLADKÝ	muž
ŠVEJDOVÁ	žena
VYBÍRALOVÁ	žena
NGUYEN THI	muž
BLECHOVÁ	žena
ZACHOVÁ	žena
SPÁČILOVÁ	žena
SRBOVÁ	žena
ŠVEJDA	muž
DUBSKÁ	žena
HROMÁDKOVÁ	žena
GAJDOŠ	muž
CIBULKOVÁ	žena
CHMELAŘOVÁ	žena
FERENCOVÁ	žena
SYNKOVÁ	žena
VÍCHOVÁ	žena
KVASNIČKA	muž
KVASNIČKOVÁ	žena
ŠOLCOVÁ	žena
PELC	muž
ČERNÍK	muž
VOJTĚCH	muž
ZÍKOVÁ	žena
MÍKA	muž
SOVA	muž
SYNEK	muž
VARGOVÁ	žena
BEDNAŘÍK	muž
KNOTKOVÁ	žena
POSPÍCHALOVÁ	žena
VOJTĚCHOVÁ	žena
BAJER	muž
ČONKOVÁ	žena
BEDNAŘÍKOVÁ	žena
TOMÁŠOVÁ	žena
BAJEROVÁ	žena
ŠUSTR	muž
HRNČÍŘ	muž
CHMELÍKOVÁ	žena
ČERNÍKOVÁ	žena
PETRÁŠ	muž
HLADKÁ	žena
ŠAFAŘÍKOVÁ	žena
KNOTEK	muž
ZACH	muž
ŠAFAŘÍK	muž
PAŠKOVÁ	žena
SVATOŠOVÁ	žena
BROŽEK	muž
ŠVÁB	muž
VONDRÁKOVÁ	žena
ŠVÁBOVÁ	žena
ŠUSTROVÁ	žena
TRČKA	muž
ZÍKA	muž
OLÁH	muž
